1111111111111111111111111111111111111111111111111111111111111111111111
1P00000000000000000000000000000000000000000000000000000000000000000001
1111111111111111111111111111111000000000000000000000000000000000000001
1000000000000000000000000000001111111111111111111111111111000000000001
100000000C000000000000000000000000000000000000000000000000111111111101
1000000000000000000000000000000000000000000000000000000000000000001001
100000000000000000000000000000000000000000000000000000000000000C001001
1000000000000000000000000000000000000000000000000000000000000000001001
1000000000000000000000000000000000000000000000000000000000000000001001
10000000000000000000000000000000000E0000000000000000000000000000001001
1000000000000000000000000000000000000000000000000000000000000000001001
1000000000000000000000000000000000000000000000000000000000000000001001
1000000000000000000000000000000000000000000000000000000000000000001001
1111111111111111111111111110000000000000000000000000000000000000001001
1000000000000000000000000001111111111111111111111111111110000000001001
1000000000000000000000000000000000000000000000000000000001111111111001
1000000000000000000000000000000000000000000000000000000000000000000001
1000000000000000000000000000000000000000000000000000000000000000000001
1000000000000000000000000000000000000000000000000000000000000000000001
1000000000000000000000000000000000000000000000000000000000000000000001
1000000000000000000000000000000000000000000000000000000000000000000001
1000000000000000000000000000000000000000000000000000000000000000000001
1000000000000000000000000000000000000000000000000000000000000000000001
1000000000000000000000000000000000000000000000000000000000000000000001
1000000000000000000000000000000000000000000000000000000000000000000001
1000000000000000000000000000000000000000000000000000000000000000000001
1000000000000000000000000000000000000000000000000000000000000000000001
1000000000000000000000000000000000000000000000000000000000000000000001
1000000000000000000000000000000000000000000000000000000000000000000001
1000000000000000000000000000000000000000000000000000000000000000000001
1000000000000000000000000000000000000000000000000000000000000000000001
1000000000000000000000000000000000000000000000000000000000000000000001
1111111111111111111111111111111111111111111111111111111111111111111111