11111111111111111111
1P0000000000000000E1
11110111111111110111
10000100000000010001
10110001111110000101
1C0001C0000C0001C0C1
11110111111111110111
10000000000000000001
10111110111110111101
1C0001C0000C0001C0C1
11110111111111110111
10000000000000000001
10111110111110111101
1C0001C0000C0001C0C1
11110111111111110111
10000000000000000001
10111110111110111101
1C0001C0000C0001C0C1
11110111111111110111
10000000000000000001
11111111001111111111
10000000000000000001
10111111111111111101
1C0001C0000C0001C0C1
11110110111110110111
10000000000000000001
11111111111111111111