1111111111
10C0000001
1001001001
1001001001
1000P000E1
1001001001
1001001001
1000000001
10C0110C01
1111111111