111111111111111111111111111111
1000000000000000000000001000C1
10P0000000000M000000000010MM01
111111110011111111001111101101
100000000000000000000000000001
101111111111110111111110111111
101C0000MC000101C0000C101C0001
100100000000100010000100010M01
10000000000000E000000000000001
111111101111111111101111111111
100000000000000000000000000001
110111111111000111111111111011
100000M00000010000000M00000001
1C00000000000100000000000000C1
111111111111111111111111111111