11111111111111111111
1P0000001C0000000E11
11110111101110111111
1C0000000001000000C1
11110111101110111111
100000000000000000C1
11111111111110111111
1C00001C000000000001
11110111101110111111
1C0000000000000000C1
11111011111111111111
10000000000000000001
11111111111111101111
1C0000000000000000C1
11111111111111111111