1111111111
1000000001
1011111101
1000000101
1111100101
1000100101
1010100101
1010111101
1000000001
1111111111
