1111111111
1C000E00C1
1011111101
1000P00101
1111100101
1C00100101
1010100101
1010111101
1C000000C1
1111111111
