111111111111111
100000000000001
100000000000001
100C000000000001
100000000C00001
10000P0000000001
100000000000001
100000000000001
100000000000001
100000000C00001
100000000000001
100000000000001
1000000000000E1
100000000000001
111111111111111