11111111111111111111111111111111111111111111111111111
1P000000000000000000000000000000000000000000000000001
11111111111111111111111111111111111111111111111111001
1C000100001000000000000000000000000000000000000000001
11110100001011111111111111111111111111111111111111111
10000100001000000000000000000000000000000000000000001
10111100001111111111111111111111111111111111111111101
10000100001000000000000000000000000000000000000000001
11110100001011111111111111111111111111111111111111111
100001000010100010000010001C01000100010001000100010C1
10111100001010101010101010100101010101010101010101001
10000100001010101010101010100101010101010101010101001
11110100001C10101010101010100101010101010101010101001
10000100001000100010100010000001000100010001000100001
10111100001111111111111111111111111111111111111111101
10000100000000000000000000000000000000000000000000001
11110100001111111111111111111111111111110000000000001
10000100000000000000000000000000000000010000000000001
10111100000000000000000000000000000000010000000000001
100001000000000000000000C0000000000000010000000000001
11110100000000000000000000000000000000010000000000001
10000100000000000000000000000000000000010000000000001
10111100000000000000000000000000000000011111111111111
10000100000000000000000000000000000000000000000000001
11110100000000000000000000000000000000000000000000001
1000010000000000000C000000000000000000000000000000C01
10000000000000000000000000000000000000000000000000001
10000000000000000000000000000000000000000000000000E01
11111111111111111111111111111111111111111111111111111