111111111111111111111111111111
100000000000000000000000000001
100C00000000000000000000000001
100000000000000000000000000001
100000000C00000000000000000001
100000000000000000000000000001
100000000000000000000000C00001
100000000000000000000000000001
100000000000C00000000000000001
100000000000000000000000000001
100000000000000000000000000001
100000000000000000000000000001
100000000000000000000000000001
100C00000000000000000000000001
100000000000000000000000000001
100000000000000000000000000001
100000000000000000000000000001
100000000000000000000000000001
100000000000000000000000000001
100000000000000000000000000001
100000000000000000000000000001
100000000000000000000000000001
100000000000000000000000000001
100000000000000000000000000001
100000000000000000000000000001
100000000000000000000000000001
100000000000000000000000000001
10000000000000000000000000P001
10000000000000000000000000E001
111111111111111111111111111111