11111
1P1C1
10101
101E1
11111
