11111
1P1C1
10101
100E1
11111
